1100000000000000
0101100100000000
0000000000000000
0000000100000000
0111110110100000
0000010010100000
0001010000000000
0011010011100000
0001001010000000
0001010000000000
0000101000000000
0110001111100000
0000000000000000
0000101000000000
0000000000000000
0010101000000000